    Key Scale: 12 (#)
    Group: Planets— 12 Mercury, 13 Luna, 14 Venus, 21 Jupiter, 27 Mars, 30 Sol, 32 Saturn
    Name (Hebrew Letter): Beth (House) (#)
    Value of Hebrew Letter: 2
    Path joins: Kether (1) and Binah (3)
    Tarot Atu: The Magus (I) (#)
    Element: — (#)
    Astrology: Mercury (#) 

Planets

    Planetary Number: 8 (#)
    Planetary Intelligence: Tiriel (#)
    Planetary Spirit: Taphthartharath (#)
    Planetary Olympic Spirit: Ophiel (#) 

Godforms

    Egyptian (selection): Thoth and Cynocephalus (#)
    Egyptian (practical): Thoth (#)
    Hindu: Hanuman, Vishnu (as Parasa-Rama) (#)
    Scandinavian: — (#)
    Greek: Hermes (#)
    Roman: Mercury [Juno, Æolus] (#)
    Christian: Sardis (#) 

Colors

    King Scale: Yellow (#)
    Queen Scale: Purple (#)
    Emperor Scale: Grey (#)
    Empress Scale: Indigo rayed violet (#) 

Material Correspondences

    Animals: Swallow, Ibis, Ape [Twin Serpents, fish, hybrids] (#)
    Plants: Vervain, Herb Mercury, Major-lane, Palm [Lime or Linden] (#)
    Precious Stones: Opal, Agate (#)
    Perfume: Mastic, White Sandal, [Nutmeg], Mace, Storax, all Fugitive Odours (#)
    Vegetable Drugs: All cerebral excitants (#)
    Mineral Drug: Mercury (#)
    The Human Body: Cerebral and Nervous Systems (#)
    Metals: Mercury (#) 

Magick & Mysticism

    Order of Qliphoth: Samael (#)
    Forty Buddhist Meditations: Yellow (#)
    Magical Weapons: The Wand or Caduceus (#)
    Magical Formula: — (#)
    Magical Power: Miracles of Healing, Gift of Tongues, Knowledge of Sciences (#)
    System of Taoism: Sun (#)
    Figure related to Pure Number: Calvary Cross (#)
    Lineal Figures of the Planets, etc., and Geomancy: Octagram (#)
    Geomantic Intelligence: Raphael (#)
    The Noble Eightfold Path: Samma Vaca (Right Speech) (#)
    Legendary Orders of Being: “Voices,” Witches and Wizards (#) 

The Four Worlds

    Heavens of Assiah: Kokab (Mercury) (#)
    God Name in Assiah: (aleph zain beth vau gimel heh) (#) 