    Key Scale: 14 (#)
    Group: Planets— 12 Mercury, 13 Luna, 14 Venus, 21 Jupiter, 27 Mars, 30 Sol, 32 Saturn
    Name (Hebrew Letter): Daleth (Door) (#)
    Value of Hebrew Letter: 4
    Path joins: Chokmah (2) and Binah (3)
    Tarot Atu: The Empress (III) (#)
    Element: — (#)
    Astrology: Venus (#) 

Planets

    Planetary Number: 7 (#)
    Planetary Intelligence: Hagiel (#)
    Planetary Spirit: Qedemel (#)
    Planetary Olympic Spirit: Hagith (#) 

Godforms

    Egyptian (selection): Hathor (#)
    Egyptian (practical): Hathoor (#)
    Hindu: Lalita (sexual aspect of Sakti) (#)
    Scandinavian: Freya (#)
    Greek: Aphrodite (#)
    Roman: Venus (#)
    Christian: Thyatira (#) 

Colors

    King Scale: Emerald green (#)
    Queen Scale: Sky blue (#)
    Emperor Scale: Early spring green (#)
    Empress Scale: Bright rose or cerise rayed pale green (#) 

Material Correspondences

    Animals: Sparrow, Dove [Sow] (#)
    Plants: Myrtle, Rose, Clover [Fig, Peach, Apple] (#)
    Precious Stones: Emerald, Turquoise (#)
    Perfume: Sandalwood, Myrtle, all Soft Voluptuous Odours (#)
    Vegetable Drugs: All aphrodisiacs (#)
    Mineral Drug: — (#)
    The Human Body: Genital System (#)
    Metals: Copper (#) 

Magick & Mysticism

    Order of Qliphoth: A’arab Zaraq (#)
    Forty Buddhist Meditations: Dark Blue (#)
    Magical Weapons: The Girdle (#)
    Magical Formula: AGAPE (#)
    Magical Power: Love-philtres (#)
    System of Taoism: Tui (#)
    Figure related to Pure Number: — (#)
    Lineal Figures of the Planets, etc., and Geomancy: Heptagram (#)
    Geomantic Intelligence: Anael (#)
    The Noble Eightfold Path: Samma Kammanto (Right Conduct) (#)
    Legendary Orders of Being: Succubi (#) 

The Four Worlds

    Heavens of Assiah: Nogah (Venus) (#)
    God Name in Assiah: (aleph cheth aleph) (#) 