    Key Scale: 13 (#)
    Group: Planets— 12 Mercury, 13 Luna, 14 Venus, 21 Jupiter, 27 Mars, 30 Sol, 32 Saturn
    Name (Hebrew Letter): Gimel (Camel) (#)
    Value of Hebrew Letter: 3
    Path joins: Kether (1) and Tiphareth (6)
    Tarot Atu: The Priestess (II) (#)
    Element: — (#)
    Astrology: Luna (#) 

Planets

    Planetary Number: 9 (#)
    Planetary Intelligence: Malkah Be Tarshishim va A’ad Be Ruah Shehaqim (#)
    Planetary Spirit: Chasmodai (#)
    Planetary Olympic Spirit: Phul ([Planets|#]]) 

Godforms

    Egyptian (selection): Chomse (#)
    Egyptian (practical): Chomse (#)
    Hindu: Chandra (as Luna) (#)
    Scandinavian: — (#)
    Greek: Artemis, Hekate (#)
    Roman: Diana (#)
    Christian: Laodicea (#) 

Colors

    King Scale: Blue (#)
    Queen Scale: Silver (#)
    Emperor Scale: Cold pale blue (#)
    Empress Scale: Silver rayed sky-blue (#) 

Material Correspondences

    Animals: Dog [Stork, Camel] (#)
    Plants: Almond, Mugwort, Hazel (as Luna), Moonwort, Ranunculus [Alder, Pomegranete] (#)
    Precious Stones: Moonstone, Pearl, Crystal (#)
    Perfume: Menstrual Blood, Camphor, Aloes, all Sweet Virginal Odours (#)
    Vegetable Drugs: Juniper, Pennyroyal, & all emmenogogues (#)
    Mineral Drug: — (#)
    The Human Body: Lymphatic Systems (#)
    Metals: Silver (#) 

Magick & Mysticism

    Order of Qliphoth: Gamaliel (#)
    Forty Buddhist Meditations: Loathsomeness of Food (#)
    Magical Weapons: Bow and Arrow (#)
    Magical Formula: ALIM (#)
    Magical Power: The White Tincture, Clairvoyance, Divination by Dreams (#)
    System of Taoism: Kan and Khwan (#)
    Figure related to Pure Number: Greek Cross (Plane), Table of Shewbread (#)
    Lineal Figures of the Planets, etc., and Geomancy: Enneagram (#)
    Geomantic Intelligence: Gabriel (#)
    The Noble Eightfold Path: Samma Sankappo (Right Aspiration) (#)
    Legendary Orders of Being: Lemures, Ghosts (#) 

The Four Worlds

    Heavens of Assiah: Levanah (Luna) (#)
    God Name in Assiah: (daleth cheth) (#) 