    Key Scale: 21 (#)
    Group: Planets— 12 Mercury, 13 Luna, 14 Venus, 21 Jupiter, 27 Mars, 30 Sol, 32 Saturn
    Name (Hebrew Letter): Kaph (Palm) (#)
    Value of Hebrew Letter: 20 (500 final)
    Path joins: Chesed (4) and Netzach (7)
    Tarot Atu: Fortune (X) (#)
    Element: — (#)
    Astrology: Jupiter (#) 

Planets

    Planetary Number: 4 (#)
    Planetary Intelligence: Yophiel (#)
    Planetary Spirit: Hismael (#)
    Planetary Olympic Spirit: Bethor (#) 

Godforms

    Egyptian (selection): Amoun-Ra (#)
    Egyptian (practical): Amoun-Ra (#)
    Hindu: Brahma, Indra (#)
    Scandinavian: — (#)
    Greek: Zeus (#)
    Roman: Jupiter, [Pluto] (#)
    Christian: Philadelphia (#) 

Colors

    King Scale: Violet (#)
    Queen Scale: Blue (#)
    Emperor Scale: Rich purple (#)
    Empress Scale: Bright blue rayed yellow (#) 

Material Correspondences

    Animals: Eagle [Praying Mantis] (#)
    Plants: Hyssop, Oak, Poplar, Fig [Arnica, Cedar] (#)
    Precious Stones: Amethyst, Lapis Lazuli (#)
    Perfume: Saffron, all Generous Odours (#)
    Vegetable Drugs: Cocaine (#)
    Mineral Drug: — (#)
    The Human Body: Digestive System (#)
    Metals: Tin (#) 

Magick & Mysticism

    Order of Qliphoth: Gha’agsheklah (#)
    Forty Buddhist Meditations: Liberality (#)
    Magical Weapons: The Sceptre (#)
    Magical Formula: — (#)
    Magical Power: Power of Acquiring Political and other Ascendency (#)
    System of Taoism: Li (#)
    Figure related to Pure Number: — (#)
    Lineal Figures of the Planets, etc., and Geomancy: Square and Rhombus (#)
    Geomantic Intelligence: Sachiel (#)
    The Noble Eightfold Path: Samma Ajivo (Right Discipline) (#)
    Legendary Orders of Being: Incubi, Nightmares (#) 

The Four Worlds

    Heavens of Assiah: Tzedeq (Jupiter) (#)
    God Name in Assiah: (aleph beth aleph) (#) 