    Key Scale: 27 (#)
    Group: Planets— 12 Mercury, 13 Luna, 14 Venus, 21 Jupiter, 27 Mars, 30 Sol, 32 Saturn
    Name (Hebrew Letter): Pé (Mouth) (#)
    Value of Hebrew Letter: 80 (800 final)
    Path joins: Netzach (7) and Hod (8)
    Tarot Atu: The Tower (XVI) (#)
    Element: — (#)
    Astrology: Mars (#) 

Planets

    Planetary Number: 5 (#)
    Planetary Intelligence: Graphiel (#)
    Planetary Spirit: Bartzabel (#)
    Planetary Olympic Spirit: Phaleg (#) 

Godforms

    Egyptian (selection): Horus (#)
    Egyptian (practical): Mentu (#)
    Hindu: Krishna (#)
    Scandinavian: Tuisco (#)
    Greek: Ares, [Athena] (#)
    Roman: Mars (#)
    Christian: Pergamos (#) 

Colors

    King Scale: Scarlet (#)
    Queen Scale: Red (#)
    Emperor Scale: Venetian red (#)
    Empress Scale: Bright red rayed azure or orange (#) 

Material Correspondences

    Animals: Horse, Bear, Wolf [Boar] (#)
    Plants: Absinthe, Rue (#)
    Precious Stones: Ruby, any red stone (#)
    Perfume: Pepper, Dragon’s Blood, all Hot Pungent Odours (#)
    Vegetable Drugs: — (#)
    Mineral Drug: — (#)
    The Human Body: Muscular System (#)
    Metals: Iron (#) 

Magick & Mysticism

    Order of Qliphoth: Golachab (#)
    Forty Buddhist Meditations: Blood-red (#)
    Magical Weapons: The Sword (#)
    Magical Formula: — (#)
    Magical Power: Works of Wrath and Vengeance (#)
    System of Taoism: Kan (#)
    Figure related to Pure Number: — (#)
    Lineal Figures of the Planets, etc., and Geomancy: Pentagram (#)
    Geomantic Intelligence: Zamael (#)
    The Noble Eightfold Path: Samma Vayamo (Right Energy) (#)
    Legendary Orders of Being: Furies, Chimæras, Boars (as in Calydon), etc. (#) 

The Four Worlds

    Heavens of Assiah: Madim (Mars) (#)
    God Name in Assiah: Adonai (#) 