    Key Scale: 30 (#)
    Group: Planets— 12 Mercury, 13 Luna, 14 Venus, 21 Jupiter, 27 Mars, 30 Sol, 32 Saturn
    Name (Hebrew Letter): Resh (Head) (#)
    Value of Hebrew Letter: 200
    Path joins: Hod (8) and Yesod (9)
    Tarot Atu: The Sun (XIX) (#)
    Element: — (#)
    Astrology: Sol (#) 

Planets

    Planetary Number: 6 (#)
    Planetary Intelligence: Nakhiel (#)
    Planetary Spirit: Sorath (#)
    Planetary Olympic Spirit: Och (#) 

Godforms

    Egyptian (selection): Ra (and many others) (#)
    Egyptian (practical): Ra (#)
    Hindu: Agni [Tejas], Yama [as God of Last Judgement] (#)
    Scandinavian: Freyr (#)
    Greek: Helios (#)
    Roman: Apollo [Ops] (#)
    Christian: Smyrna (#) 

Colors

    King Scale: Orange (#)
    Queen Scale: Gold yellow (#)
    Emperor Scale: Rich amber (#)
    Empress Scale: Amber rayed red (#) 

Material Correspondences

    Animals: Lion, Sparrowhawk [Leopard] (#)
    Plants: Sunflower, Laural, Heliotrop [Nut, Galangal] (#)
    Precious Stones: Crysolith (#)
    Perfume: Olibanum, Cinnamon, all Glorious Odours (#)
    Vegetable Drugs: Alcohol (#)
    Mineral Drug: — (#)
    The Human Body: Circulatory System (#)
    Metals: Gold (#) 

Magick & Mysticism

    Order of Qliphoth: Thagiriron (#)
    Forty Buddhist Meditations: Light (#)
    Magical Weapons: The Lamen or Bow and Arrow (#)
    Magical Formula: IAO : INRI (#)
    Magical Power: The Red Tincture, Power of Acquiring Wealth (#)
    System of Taoism: Li and Khien (#)
    Figure related to Pure Number: — (#)
    Lineal Figures of the Planets, etc., and Geomancy: Hexagram (#)
    Geomantic Intelligence: Michael (#)
    The Noble Eightfold Path: Samma Samadhi (Right Rapture) (#)
    Legendary Orders of Being: Will o’ the Wisp (#) 

The Four Worlds

    Heavens of Assiah: Shemesh (Sol) (#)
    God Name in Assiah: (aleph lamed cheth) (#) 