    Key Scale: 5 (#)
    Name: Geburah (Strength) (#)
    Astrology: Mars (#) 

Godforms

    Egyptian (selection): Horus, Nephthys (#)
    Egyptian (practical): Horus (#)
    Hindu: Vishnu, Varruna-Avatar (#)
    Scandinavian: Thor (#)
    Greek: Ares, Hades (#)
    Roman: Mars (#)
    Christian: Christ coming to Judge the World (#) 

Tarot

    General Attribution: The 4 Fives (#)
    Titles & Attributions
        Wands: Strife (Saturn in Leo) (#)
        Cups: Disappointment (Mars in Scorpio) (#)
        Swords: Defeat (Venus in Aquarius) (#)
        Discs: Worry (Mercury in Taurus) (#) 

Colors

    King Scale: Orange (#)
    Queen Scale: Scarlet red (#)
    Emperor Scale: Bright scarlet (#)
    Empress Scale: Red flecked black (#) 

Material Correspondences

    Animals: Basilisk (#)
    Plant: Oak, Nux Vomica, Nettle [Hickory] (#)
    Precious Stone: Ruby (#)
    Perfume: Tobacco (#)
    Vegetable Drug: Nux Vomica, Nettle [Cocaine, Atropine] (#)
    Mineral Drug: Iron, Sulphur (#)
    Alchemical Metal: Gold (#) 

Magick & Mysticism

    Element: Fire (#)
    Magical Weapons: The Sword, Spear, Scourge, or Chain (#)
    Magical Formula: AGLA, ALHIM (#)
    Parts of the Soul: Ruach (The Intellect) (#)
    Lineal Figures of the Planets, &c., and Geomancy: The Tesseract (#)
    Chakra: Anahata (heart) (#)
    The Soul (Hindu): Lower Manas (#)
    Quarter: Height (#)
    Order of Qliphoth: Golachab (Burners) (#)
    Forty Buddhist Meditations: Death (#)
    Magical Power: The Vision of Power (#)
    System of Taoism: â€” (#)
    Figure related to Pure Number: The Rose (#) 

The Four Worlds

    Heaven of Assiah: Madim (Sphere of Mars) (#)
    God Name in Assiah: Elohim Gibor (The Mighty Gods)(#)
    Archangel of Assiah: Kamael (#)
    Angels of Assiah: Seraphim (Fiery serpents) (#)
    Divine Name of Briah: (Yod He Vau Daleth) (#)
    Angel of Briah: Tharshish (#)
    Choir of Angels in Briah: Tharshishim (#)
    Palace of Briah: Hekel Zakoth (Palace of Merit) (#) 