    Key Scale: 1 (#)
    Name: Kether (Crown) (#)
    Astrology: Pluto (#) 

Godforms

    Egyptian (selection): Ptah, Asar un Nefer, Hadith, Heru-Ra-Ha (#)
    Egyptian (practical): Ptah (#)
    Hindu: Parabrahm, Shiva, Brahma (#)
    Scandinavian: Wotan (#)
    Greek: Zeus, Iacchus (#)
    Roman: Jupiter (#)
    Christian: God the 3 in 1 (#) 

Tarot

    General Attribution: The 4 Aces (#)
    Titles & Attributions
        Wands: The Root of the Powers of Fire (#)
        Cups: The Root of the Powers of Water (#)
        Swords: The Root of the Powers of Air (#)
        Discs: The Root of the Powers of Earth (#) 

Colors

    King Scale: Brilliance (#)
    Queen Scale: White brilliance (#)
    Emperor Scale: White brilliance (#)
    Empress Scale: White flecked gold (#) 

Material Correspondences

    Animals: God [Swan, Hawk] (#)
    Plant: Almond in Flower [Banyan] (#)
    Precious Stone: Diamond (#)
    Perfume: Ambergris (#)
    Vegetable Drug: Elixir Vitæ (#)
    Mineral Drug: Aur. Pot. (#)
    Alchemical Metal: Metallic Radix (#) 

Magick & Mysticism

    Element: Root of Air (#)
    Magical Weapons: Swastika or Fylfot Cross, Crown, [The Lamp] (#)
    Magical Formula: — (#)
    Parts of the Soul: Yechidah (The Self) (#)
    Lineal Figures of the Planets, &c., and Geomancy: The Point (#)
    Chakra: Sahasrara (above Head) (#)
    Quarter: — (#)
    Order of Qliphoth: Thaumiel (#)
    Forty Buddhist Meditations: Indifference (#)
    Magical Power: Union with God (#)
    System of Taoism: Shang Ti (also the Tao) (#)
    Figure related to Pure Number: — (#) 

The Four Worlds

    Heaven of Assiah: Rashith ha-Gilgalim (Sphere of Primum Mobile) (#)
    God Name in Assiah: Eheieh (#)
    Archangel of Assiah: Metatron (#)
    Angel of Assiah: Chaioth ha-Qadosh (Holy living creatures) (#)
    Divine Name of Briah: AL (#)
    Angel of Briah: Yehuel (#)
    Choir of Angels in Briah: Seraphim (#)
    Palace of Briah: Hekel Qadosh Qadeshim (#) 