    Key Scale: 10 (#)
    Name: Malkuth (Kingdom) (#)
    Astrology: Earth (#) 

Godforms

    Egyptian (selection): Seb. Lower (i.e. unwedded) Isis and Nephthys [Sphinx as synthesis of Elements] (#)
    Egyptian (practical): Osiris (#)
    Hindu: Lakshmi [Kundalini] (#)
    Scandinavian: — (#)
    Greek: Persephone, Adonis, Psyche (#)
    Roman: Ceres (#)
    Christian: Ecclesia Xsti, the Virgin Mary (#) 

Tarot

    General Attribution: The 4 Tens, and Empresses or Princesses (#)
    Titles & Attributions
        Wands: Oppression (Saturn in Sagittarius) (#)
        Cups: Satiety (Mars in Pisces) (#)
        Swords: Ruin (Sol in Gemini) (#)
        Discs: Wealth (Mercury in Virgo) (#) 

Colors

    King Scale: Yellow (#)
    Queen Scale: Citrine, olive, russet, and black (#)
    Emperor Scale: Citrine, olive, russet, and black, flecked with gold (#)
    Empress Scale: Black rayed yellow (#) 

Material Correspondences

    Animals: Sphinx (#)
    Plants: Willow, Lily, Ivy [Pomegranete, all cereals] (#)
    Precious Stones: Rock Crystal (#)
    Perfume: Dittany of Crete (#)
    Vegetable Drugs: Corn (#)
    Mineral Drug: Mag. Sulph. (#)
    Alchemical Metal: Medicina Metallorum (#) 

Magick & Mysticism

    Element: Earth (#)
    Magical Weapons: The Magick Circle and Triangle (#)
    Magical Formula: VITRIOL (#)
    Parts of the Soul: Nephesh (The Animal Soul) (#)
    Lineal Figures of the Planets, &c., and Geomancy: — (#)
    Chakra: — (#)
    The Soul (Hindu): Sthula Sharira (#)
    Quarter: North (#)
    Order of Qliphoth: Lilith (The Evil Woman) (#)
    Forty Buddhist Meditations: Sangha, The Body (#)
    Magical Power: The Vision of the Holy Guardian Angel or of Adonai (#)
    System of Taoism: Khan (#)
    Figure related to Pure Number: Altar (Double Cube), Calvary Cross (#) 

The Four Worlds

    Heaven of Assiah: Cholem Yesodoth (Sphere of the Elements) (#)
    God Name in Assiah: Adonai Melekh (My Lord the King) (#)
    Archangel of Assiah: Sandalphon (#)
    Angels of Assiah: Ashim (Flames) (#)
    Divine Name of Briah: (aleph lamed—aleph resh daleth yod) (#)
    Angel of Briah: Michael (#)
    Choir of Angels in Briah: Aralim (#)
    Palace of Briah: Hekel Lebanath ha-Saphir (Palace of Crystalline Whiteness) (#) 