    Key Scale: 7 (#)
    Name: Netzach (Victory) (#)
    Astrology: Venus (#) 

Godforms

    Egyptian (selection): Hathoor (#)
    Egyptian (practical): Hathoor (#)
    Hindu: Bhavani (#)
    Scandinavian: Freya (#)
    Greek: Aphrodite, Nike (#)
    Roman: Venus (#)
    Christian: Messiah, Lord of Hosts (#) 

Tarot

    General Attribution: The 4 Sevens (#)
    Titles & Attributions
        Wands: Valour (Mars in Leo) (#)
        Cups: Debauch (Venus in Scorpio) (#)
        Swords: Futility (Luna in Aquarius) (#)
        Discs: Failure (Saturn in Taurus) (#) 

Colors

    King Scale: Amber (#)
    Queen Scale: Emerald (#)
    Emperor Scale: Bright yellow green (#)
    Empress Scale: Olive flecked gold (#) 

Material Correspondences

    Animals: Iynx [Raven, all carrion birds] (#)
    Plants: Rose [Laurel] (#)
    Precious Stones: Emerald (#)
    Perfume: Benzoin, Rose, Red Sandal (#)
    Vegetable Drugs: Damiana, Cannabis Indica [Anhalonium] (#)
    Mineral Drug: Arsenic (#)
    Alchemical Metal: Copper (#) 

Magick & Mysticism

    Element: Fire (#)
    Magical Weapons: The Lamp and Girdle (#)
    Magical Formula: ARARITA (#)
    Parts of the Soul: Ruach (The Intellect) (#)
    Lineal Figures of the Planets, &c., and Geomancy: — (#)
    Chakra: Manipura (Solar Plexus) (#)
    The Soul (Hindu): Kama (#)
    Quarter: East (#)
    Order of Qliphoth: A’arab Zaraq (Dispersing Ravens) (#)
    Forty Buddhist Meditations: The Gods (#)
    Magical Power: The Vision of Beauty Triumphant (#)
    System of Taoism: — (#)
    Figure related to Pure Number: A Rose (7 x 7), Candlestick (#) 

The Four Worlds

    Heaven of Assiah: Nogah (Sphere of Venus) (#)
    God Name in Assiah: Jehovah Tzabaoth (#)
    Archangel of Assiah: Haniel (#)
    Angels of Assiah: Elohim (Gods) (#)
    Divine Name of Briah: Elohim (#)
    Angel of Briah: Usiel (#)
    Choir of Angels in Briah: Malakim (#)
    Palace of Briah: Hekel Etzem Shamaim (Palace of the Substance of Heaven) (#) 