    Key Scale: 6 (#)
    Name: Tiphareth (Beauty) (#)
    Astrology: Sol (#) 

Godforms

    Egyptian (selection): Asar, Ra [On, Hrumachis] (#)
    Egyptian (practical): Ra (#)
    Hindu: Vishu-Hari-Krishna-Rama (#)
    Scandinavian: Balder (#)
    Greek: Iacchus, Apollo, Adonis [Dionysus, Bacchus] (#)
    Roman: Apollo [Bacchus, Aurora] (#)
    Christian: God the Son (and Maker of fine Weather) (#) 

Tarot

    General Attribution: The 4 Sixes, also Emperors or Princes (#)
    Titles & Attributions
        Wands: Victory (Jupiter in Leo) (#)
        Cups: Pleasure (Sol in Scorpio) (#)
        Swords: Science (Murcury in Aquarius) (#)
        Discs: Success (Luna in Taurus) (#) 

Colors

    King Scale: Clear pink rose (#)
    Queen Scale: Yellow (gold) (#)
    Emperor Scale: Rich salmon (#)
    Empress Scale: Gold amber (#) 

Material Correspondences

    Animals: Phoenix, Lion, Child [Spider, Pelican] (#)
    Plants: Acacia, Bay, Laurel, Vine [Oak, Gorse, Ash, Aswata] (#)
    Precious Stones: Topaz, Yellow Diamond (#)
    Perfume: Olibanum (#)
    Vegetable Drugs: Stramonium, Alcohol, Digitalis, Coffee (#)
    Mineral Drug: — (#)
    Alchemical Metal: Iron (#) 

Magick & Mysticism

    Element: Air (#)
    Magical Weapons: The Lamen or Rosy Cross (#)
    Magical Formula: ABRAHADABRA, IAO:INRI (#)
    Parts of the Soul: Ruach (The Intellect) (#)
    Lineal Figures of the Planets, &c., and Geomancy: — (#)
    Chakra: Anahata (heart) (#)
    The Soul (Hindu): Lower Manas (#)
    Quarter: Depth (#)
    Order of Qliphoth: Thagiriron (Disputers) (#)
    Forty Buddhist Meditations: Buddha (#)
    Magical Power: The Vision of the Harmony of Things (also the Mysteries of the Crucifixion), [Beatific Vision] (#)
    System of Taoism: Li (#)
    Figure related to Pure Number: Calvary Cross, Truncated Pyramid, Cube (#) 

The Four Worlds

    Heaven of Assiah: Shemesh (Sphere of Sol) (#)
    God Name in Assiah: Jehovah Eloah Va-Daath (#)
    Archangel of Assiah: Raphael (#)
    Angels of Assiah: Malakim (Kings) (#)
    Divine Name of Briah: IHVH (Jehovah) (#)
    Angel of Briah: Metatron (#)
    Choir of Angels in Briah: Chashmalim (#)
    Palace of Briah: Hekel Ratzon (Palace of Benevolence) (#) 